1111111111111111
1E00000000000CC1
1010010100110011
1010010010110011
1P0000000C00C0C1
1111111111111111